Welcome
An Interactive Fiction
Release 1 / Serial number 170209 / Inform 7 build 6M62 (I6/v6.33 lib 6/12N) SD

Government HQ Lobby
You are a wanted criminal with a bounty of 320 million Berries. (The average notorious criminal usually carries a 70 million bounty.) You have just escaped from a notorious prison by the name of Impel Down and must set sail from the infamous island in the sea, Ennies Lobby. This city-island floats above the sea as it is resides in the center of a "hole" in the ocean. A gigantic circular waterfall pours into an unknown abyss that surrounds this island. However, what will you do get these shackles off?  

You can see a desk and a chair here.

>check the chair
This seat is warm. Someone was here recently.

>go south
You need to find a way to get these shackles off first.

* * *

>check under the desk
You can't see any such thing.

* * *

>desk
That's not a verb I recognise.

>examine desk
You see nothing special about the desk.

>e desk
I only understood you as far as wanting to (go) e.

>examine chair
This seat is warm. Someone was here recently.

>look under chair
You find nothing of interest.

>look under desk
You find Sunglasses!

>inventory
You are carrying nothing.

>pick up sunglasses
Taken.

>wear sunglasses
You put on Sunglasses.

* * *

>e
East Wing
Inside the east wing you see a long hall with various paintings of famous admirals and soldiers. You even see a painting of Borsalino, the admiral who captured you. 

You can see Painting of Borsalino here.

>look under painting of borsalino
You found a dusty navy coat!

Maybe I should wear this over my shoulders..

>wear dusty navy coat
(first taking Dusty navy coat)
You put on Dusty navy coat.

* * *

>east
East Wing
Inside the east wing you see a long hall with various paintings of famous admirals and soldiers. You even see a painting of Borsalino, the admiral who captured you. 

You can see Painting of Borsalino here.

>look under painting of borsalino
You found a dusty navy coat!

Maybe I should wear this over my shoulders..

* * *

>wear dusty navy coat
(first taking Dusty navy coat)
You put on Dusty navy coat.

>east
You can't go that way.

>west
Government HQ Lobby
 You're back where you started. 

You can see a desk and a chair here.

>look under desk
You find Sunglasses!

>wear sunglasses
(first taking Sunglasses)
You put on Sunglasses.

>west
West Wing
A nice, boring looking hall..

You can see a large amount of money here.

>north
Key room
You can see Sleeping Officer and a painting of keys here.

>look under painting of keys
You find the Shackle keys! 

 (Sleeping Officer) zZZZzZZZZzzzz... huh... Borsalino? What brings you here?. . ZzzzzzZzZzz

>take shackle keys
Taken.

>south
West Wing
A nice, boring looking hall..

You can see a large amount of money here.

>east
Government HQ Lobby
 You're back where you started. 

You can see a desk and a chair here.

>south
Ahhhh, those shackles were so uncomfortable! I need to get out of here.

HQ Entrance

>south
Ennies Lobby
You stand there flustered as you gaze across the edge of the island, only to see an enormous waterfall enclosing the island. Ennies Lobby is known as a military island however you will find all sorts of crowds within the main city: government officials, thugs, local shops, and families.

>north
HQ Entrance

>east
HQ Garden
You can see a shrub (in which is a very rare sword), a flowers and a gazebo here.

>take a very rare sword
Taken.

>east
You can't go that way.

>west
HQ Entrance

>south
Ennies Lobby

>east
Shady Alleyway

>north
Local Bar
 The local bar is where military, locals, and travelers all gather to enjoy a nice beer or two. 

You can see Black Market Arms Vendor here.

>give a very rare sword to black market arms vendor
Black Market Arms Vendor doesn't seem interested.

* * *

>examine
(the ship)
The ship is large and sailable.

* * *

>examine chair
This seat is warm. Someone was here recently.

>examine desk
You see nothing special about the desk.

>look under hair
You can't see any such thing.

>look under chair
You find nothing of interest.

* * *

>wear sunglasses
(first taking Sunglasses)
You put on Sunglasses.

>go east
East Wing
Inside the east wing you see a long hall with various paintings of famous admirals and soldiers. You even see a painting of Borsalino, the admiral who captured you. 

You can see Painting of Borsalino here.

>inspect painting of borsalino
That's not a verb I recognise.

>examine painting of borsalino
The painting portrays Borsalino wearing his tinted aviator sunglasses in his iconic yellow, pin-striped suit with his admiral coat over his shoulders.

I didn't think a painting could make him look any uglier than he already is.

>go north
HQ Lounge
You find yourself in the lounge of the HQ however there is only one soldier in here who seems awfully dumb.  

You can see Dumb Navy Officer here.

>ask dumb navy officer about shackle keys
derr, whats it err to ya? 

 ..oh so your patrol officer is looking for them? Well... derrr, I did see a pair lying around in the west wing.  The shackle keys? uhhh... they're in the Key Room behind the painting of keys.

* * *

>examine desk
You see nothing special about Desk.

>examine chair
This seat is warm. Someone was here recently.

>east
East Wing
Inside the east wing you see a long hall with various paintings of famous admirals and soldiers. You even see a painting of Borsalino, the admiral who captured you.

You can see Painting of Borsalino here.

>north
HQ Lounge
 You find yourself in the lounge of the HQ however there is only one soldier in here who seems awfully dumb.  

You can see Dumb Navy Officer here.

>ask the Dumb Navy Officer about shackle keys
derr, whats it err to ya? 

 ..oh so your patrol officer is looking for them? Well... I did see a pair lying around in the west wing.

>south
East Wing
Inside the east wing you see a long hall with various paintings of famous admirals and soldiers. You even see a painting of Borsalino, the admiral who captured you.

You can see Painting of Borsalino here.

>north
HQ Lounge
  You probably shouldn't keep coming back here.. 

You can see Dumb Navy Officer here.

* * *

>go east
East Wing
Inside the east wing you see a long hall with various paintings of famous admirals and soldiers. You even see a painting of Borsalino, the admiral who captured you.

You can see Painting of Borsalino here.

>examine painting
You see nothing special about Painting of Borsalino.

I didn't think he could look any uglier than he already is.

* * *

>go east
East Wing
Inside the east wing you see a long hall with various paintings of famous admirals and soldiers. You even see a painting of Borsalino, the admiral who captured you.

You can see Painting of Borsalino here.

>examine painting of borsalino
The painting portrays Borsalino in his iconic yellow suit sporting his admiral coat over his shoulders.

I didn't think he could look any uglier than he already is.

* * *

>go south
You need to find a way to get these shackles off first.

>go east
You can't go that way.

>go west
You can't go that way.

>go north
You can't go that way.

>check the desk
You see nothing special about Desk.

>check inside the desk
I only understood you as far as wanting to check inside.

* * *

>hide
That's not a verb I recognise.

>hide
That's not a verb I recognise.

>wait
Time passes.

>wait
Time passes.

* * *

>look under desk
You find Sunglasses!

>pick up sunglasses
Taken.

>give sunglasses to officer
Officer doesn't seem interested.

>say hello to officer
There is no reply.

* * *

>wear sunglasses
(first taking Sunglasses)
You put on Sunglasses.

>east
East Wing
Inside the east wing you see a long hall with various paintings of famous admirals and soldiers. You even see a painting of Borsalino, the admiral who captured you. 

You can see Painting of Borsalino here.

* * *

>west
Government HQ Lobby
 You're back where you started. 

You can see a desk and a chair here.

>south
I need to find a way to get these shackles off first.

>east
East Wing

You can see Painting of Borsalino here.

>west
Government HQ Lobby
 You're back where you started. 

You can see a desk and a chair here.

>west
West Wing
A nice, boring looking hall..

You can see a large amount of money here.

* * *

>wear dusty navy coat
(first taking Dusty navy coat)
You put on Dusty navy coat.

>west
Government HQ Lobby
 You're back where you started. 

You can see a desk and a chair here.

* * *

>north
Key room
You can see Sleeping Officer and a painting of keys here.

>look under painting of shackle keys
You can't see any such thing.

>look under painting of keys
You find the Shackle keys! 

 (Sleeping Officer) zZZZzZZZZzzzz... huh... Borsalino? What brings you here?. . ZzzzzzZzZzz

>pick up shackle keys
Taken.

>south
West Wing
A nice, boring looking hall..

You can see a large amount of money here.

* * *

>south
Ahhhh, those shackles were so uncomfortable! I need to get out of here.

HQ Entrance

>east
HQ Garden
You can see a shrub (in which is a very rare sword), a flowers and a gazebo here.

>west
HQ Entrance

>west
You can't go that way.

>east
HQ Garden
You can see a shrub (in which is a very rare sword), a flowers and a gazebo here.

>pick up very rare sword
Taken.

>south
You can't go that way.

>east
You can't go that way.

>north
You can't go that way.

>west
HQ Entrance

>south
Ennies Lobby
You stand there flustered as you gaze across the edge of the island, only to see an enormous waterfall enclosing the island. Ennies Lobby is known as a military island however you will find all sorts of crowds within the main city: government officials, thugs, local shops, and families.

>east
Shady Alleyway

>north
Local Bar
You can see Black Market Arms Vendor here.

>give very rare sword to black market arms vendor
Black Market Arms Vendor doesn't seem interested.

>east
Can't go this way.

>south
Shady Alleyway

>east
You can't go that way.

>west
Ennies Lobby
You stand there flustered as you gaze across the edge of the island, only to see an enormous waterfall enclosing the island. Ennies Lobby is known as a military island however you will find all sorts of crowds within the main city: government officials, thugs, local shops, and families.

>west
Marketplace
You can see Produce vendor, Weapons vendor and Shady individual here.

>talk to produce vendor
That's not a verb I recognise.

>ask produce vendor about escaping the island
There is no reply.

* * *

>west
West Wing
A nice, boring looking hall..

You can see a large amount of money here.

>pick up large amount of money
 Is this a trap? Meh.

Taken.

>north
Key room
You can see Sleeping Officer and a painting of keys here.

>examine painting of keys
A beautiful and inspiring rendition of the keys that you're looking for.

Is this a joke?

>look under painting of keys
You find the Shackle keys! 

 (Sleeping Officer) zZZZzZZZZzzzz... huh... Borsalino?.. ZzzzzzZzZzz

>south
West Wing
A nice, boring looking hall..

You can see Shackle keys here.

* * *

>wear sunglasses
(first taking Sunglasses)
You put on Sunglasses.

>esat
That's not a verb I recognise.

>east
East Wing
Inside the east wing you see a long hall with various paintings of famous admirals and soldiers. You even see a painting of Borsalino, the admiral who captured you. 

You can see Painting of Borsalino here.

* * *

>wear dusty navy coat
(first taking Dusty navy coat)
You put on Dusty navy coat.

>north
HQ Lounge
You find yourself in the lounge of the HQ however there is only one soldier in here who seems awfully dumb.  

You can see Dumb Navy Officer here.

>ask dusty navy officer about shackle keys
You can only do that to something animate.

>shackle keys
That's not a verb I recognise.

>ask dumb navy officer about shackle keys
derr, whats it err to ya? 

 ..oh so your patrol officer is looking for them? Well... derrr, I did see a pair lying around in the west wing.

>ask about the painting of borsalino
You can't see any such thing.

>ask dumb navy officer about painting of borsalino
Borsalino.... I heard he captured a criminal worth 320 million Berries! Can you believe that?

* * *

>go east
East Wing
Inside the east wing you see a long hall with various paintings of famous admirals and soldiers. You even see a painting of Borsalino, the admiral who captured you. 

You can see Painting of Borsalino here.

>look under painting of borsalino
You found a dusty navy coat!

Maybe I should wear this over my shoulders..

* * *

>wear dusty navy coat
(first taking Dusty navy coat)
You put on Dusty navy coat.

>west
Government HQ Lobby
 You're back where you started. 

You can see a desk, Officer and a chair here.

>west
West Wing
A nice, boring looking hall..

You can see a large amount of money here.

* * *

>look under painting of keys
You find the Shackle keys! 

 (Sleeping Officer) zZZZzZZZZzzzz... huh... Borsalino? What brings you here?. . ZzzzzzZzZzz

>south
West Wing
A nice, boring looking hall..

You can see a large amount of money here.

>east
Government HQ Lobby
 You're back where you started. 

You can see a desk, Officer and a chair here.

>south
I need to find a way to get these shackles off first.

>west
West Wing
A nice, boring looking hall..

You can see a large amount of money here.

>north
Key room
You can see Shackle keys, Sleeping Officer and a painting of keys here.

>pick up shackle keys
Taken.

* * *

>east
Government HQ Lobby
 You're back where you started. 

You can see a desk, Officer and a chair here.

>south
Ahhhh, those shackles were so uncomfortable! I need to get out of here.

HQ Entrance

* * *

>north
Local Bar
You can see Black Market Arms Vendor here.

>escaping the island
That's not a verb I recognise.

>ask black market arms vendor about escaping the island
There is no reply.

>ask black market arms vendor about rare weapons
There is no reply.

>ask black market arms vendor
What do you want to ask Black Market Arms Vendor for?

>rare weapons
You can't see any such thing.

>ask black market arms vendor about rare weapons
There is no reply.

>east
Can't go this way.

>west
You can't go that way.

>south
Shady Alleyway

>west
Ennies Lobby
You stand there flustered as you gaze across the edge of the island, only to see an enormous waterfall enclosing the island. Ennies Lobby is known as a military island however you will find all sorts of crowds within the main city: government officials, thugs, local shops, and families.

>north
Ahhhh, those shackles were so uncomfortable! I need to get out of here.

HQ Entrance

* * *

>wear sunglasses
(first taking Sunglasses)
You put on Sunglasses.

>right
That's not a verb I recognise.

>east
East Wing
Inside the east wing you see a long hall with various paintings of famous admirals and soldiers. You even see a painting of Borsalino, the admiral who captured you. 

You can see Painting of Borsalino here.

* * *

>east
You can't go that way.

>east
You can't go that way.

* * *

>south
West Wing
A nice, boring looking hall..

You can see a large amount of money here.

>esat
That's not a verb I recognise.

>south
You can't go that way.

>esat
That's not a verb I recognise.

* * *

>south
You can't go that way.

>east
Government HQ Lobby
 You're back where you started. 

You can see a desk and a chair here.

* * *

>south
Ennies Lobby
You stand there flustered as you gaze across the edge of the island, only to see an enormous waterfall enclosing the island. Ennies Lobby is known as a military island however you will find all sorts of crowds within the main city: government officials, thugs, local shops, and families.

>west
Marketplace
You can see Produce vendor, Weapons vendor and Shady Individual here.

>ask shady individual about escaping the island
----->

>west
You can't go that way.

>north
You can't go that way.

>east
Ennies Lobby

>east
Shady Alleyway

* * *

>north
Local Bar
 The local bar is where military, locals, and travelers all gather to enjoy a nice beer or two. 

You can see Black Market Arms Vendor here.

>ask black market arms vendor about escaping the island
Nothing is free in this world... offer me something and maybe i'll help ya out

>rare weapons
That's not a verb I recognise.

>ask black market arms vendor about rare weapons
There are some rare weapons on the island.... if you're lucky you can find some lying around HQ.... but I ain't ever going there.

* * *

I beg your pardon?

I beg your pardon?

>look under painting of keys
You find nothing of interest.

* * *

>look uner desk
You can't see any such thing.

>look under desk
You find Sunglasses!

* * *

>north
Key room
You can see Sleeping Officer and a painting of keys here.

>look under painting of keys
(Sleeping Officer) zzzZzzzZz.. Huh.... HEY! WHAT ARE YOU DOING? 

 You got caught and were sent back to prison!

    *** The End ***

Would you like to RESTART, RESTORE a saved game, QUIT or UNDO the last command?

* * *

>north
Weapons Room

>east
HQ Lounge
You find yourself in the lounge of the HQ however there is only one soldier in here who seems awfully dumb.  

You can see Dumb Navy Officer here.

* * *

>pick up sunglasses
Taken.

* * *

>wear sunglasses
You put on Sunglasses.

>wearing
That's not a verb I recognise.

>outfit
That's not a verb I recognise.

>clothes
That's not a verb I recognise.

>inventory
You are carrying:
  Sunglasses (being worn)

* * *

>south
You can't go that way.

>north
Can't go this way.

>east
Can't go this way.

* * *

>south
You can't go that way.

>west
West Wing
You can see a large amount of money and a painting of keys here.

>look under painting of keys
You find the Shackle keys!

>west
You can't go that way.

>east
Government HQ Lobby
 You're back where you started. 

You can see Desk and Chair here.

>south
I need to find a way to get these shackles off first.

>south
I need to find a way to get these shackles off first.

>west
West Wing
You can see Shackle keys, a large amount of money and a painting of keys here.

>pick up shackle keys
Taken.

>east
Government HQ Lobby
 You're back where you started. 

You can see Desk and Chair here.

>south
Ahhhh, those shackles were so uncomfortable! I need to get out of here.

HQ Corridor

* * *

>switch on switch 1
beep boop
You switch Switch 1 on.

>switch on switch 2
beep boop
You switch Switch 2 on.

>switch on switch 5
beep boop

    *** -RZZZZHHHHHBBRR BRRR BRRR VROOOM VROOOM- It started!! Congratulations, you managed to escape! ***

Would you like to RESTART, RESTORE a saved game, QUIT or UNDO the last command?

* * *

>take sunglasses
You can't see any such thing.

>look under desk
You find Sunglasses!

* * *

>east
Government HQ Lobby
 You're back where you started. 

You can see a desk and a chair here.

>south
I need to find a way to get these shackles off first.

* * *

>north
Key room
You can see Shackle keys, Sleeping Officer and a painting of keys here.

>take shackle keys
Taken.

* * *

>east
HQ Garden
You can see a shrub (in which is a very rare sword), a flowers and a gazebo here.

>look inside the shrub
In the shrub is a very rare sword.

>take the very rare sword
Taken.

>south
You can't go that way.

>west
HQ Entrance

* * *

>south
Ennies Lobby
You stand there flustered as you gaze across the edge of the island, only to see an enormous waterfall enclosing the island. Ennies Lobby is known as a military island however you will find all sorts of crowds within the main city: government officials, thugs, local shops, and families.

>west
Marketplace
You can see Produce vendor, Weapons vendor and Shady individual here.

* * *

>talk to produce vendor
That's not a verb I recognise.

>ask produce vendor
What do you want to ask Produce vendor for?

>ask produce vendor about ennies lobby
GET YOUR PRODUCE, FRESH OUT THE GARDEN

>ask shady individual about ennies lobby
There is no reply.

>ask shady individual about ennies lobby
There is no reply.

>go east
Ennies Lobby

>go esat
You can't see any such thing.

>go east
Shady Alleyway

>north
Local Bar
 The local bar is where military, locals, and travelers all gather to enjoy a nice beer or two. 

You can see Black Market Arms Vendor here.

>give black market arms vendor the very rare sword
Black Market Arms Vendor doesn't seem interested.

>give black market arms vendor a very rare sword
Black Market Arms Vendor doesn't seem interested.

>ask black market arms vendor about escaping the island
There is no reply.

* * *

>west
West Wing
A nice, boring looking hall..

You can see a large amount of money here.

>examine painting of keys
You see nothing special about the painting of keys.

Is this a joke?

* * *

>west
West Wing
A nice, boring looking hall..

You can see a large amount of money here.

>look inside the painting of keys
In the painting of keys is Shackle keys.

* * *

>west
West Wing
A nice, boring looking hall..

You can see a large amount of money here.

>look under the painting of keys
You find the Shackle keys!

>east
Government HQ Lobby
  You're back where you started. 

You can see Desk and Chair here.

>south
You need to find a way to get these shackles off first.

>west
West Wing
You can see Shackle keys, a large amount of money and a painting of keys here.

* * *

>pick up shackle keys
Taken.

>inventory
You are carrying:
  Shackle keys

>east
Government HQ Lobby
  You're back where you started. 

You can see Desk and Chair here.

>south
HQ Corridor

* * *

>north
Key room
You can see Sleeping Officer and a painting of keys here.

>ask Sleeping Officer about Shackle keys
..zzzZzzZzZzZZzz...

* * *

>examine painting of keys
A beautiful and inspiring rendition of the keys that you're looking for.

Is this a joke?

>look under the painting of keys
(Sleeping Officer) zzzZzzzZz.. Huh.... HEY! WHAT ARE YOU DOING? 

 You got caught and were sent back to prison!

    *** The End ***

Would you like to RESTART, RESTORE a saved game, QUIT or UNDO the last command?

* * *

>west
West Wing
A nice, boring looking hall..

You can see a large amount of money here.

>pick up the money
 Is this a trap? Meh.

Taken.

>inventory
You are carrying:
  a large amount of money

* * *

>west
West Wing
A nice, boring looking hall..

You can see a large amount of money here.

>take a large amount of money
 Is this a trap? Meh.

Taken.

>east
Government HQ Lobby
 You're back where you started. 

You can see a desk and a chair here.

>east
East Wing
Inside the east wing you see a long hall with various paintings of famous admirals and soldiers. You even see a painting of Borsalino, the admiral who captured you. 

You can see Painting of Borsalino here.

>north
HQ Lounge
You find yourself in the lounge of the HQ however there is only one soldier in here who seems awfully dumb.  

You can see Dumb Navy Officer here.

>give a large amount of money to dumb navy officer
You give the large amount of money to Dumb Navy Officer.

>south
East Wing

You can see Painting of Borsalino here.

>look under painting of borsalino
You found a dusty navy coat!

Maybe I should wear this over my shoulders..

>dusty navy coat
That's not a verb I recognise.

>wear dusty navy coat
(first taking Dusty navy coat)
You put on Dusty navy coat.

* * *

>wear sunglasses
(first taking Sunglasses)
You put on Sunglasses.

>west
West Wing
A nice, boring looking hall..

>north
Key room
You can see Sleeping Officer and a painting of keys here.

* * *

>take shackle keys
Taken.

>south
West Wing
A nice, boring looking hall..

>east
Government HQ Lobby
 You're back where you started. 

You can see a desk and a chair here.

* * *

>north
Local Bar
 The local bar is where military, locals, and travelers all gather to enjoy a nice beer or two. 

You can see Black Market Arms Vendor here.

>north
You can't go that way.

>south
Shady Alleyway

>west
Ennies Lobby

>north
HQ Entrance

* * *

>take a very rare sword
Taken.

>west
HQ Entrance

* * *

>east
Shady Alleyway

>north
Local Bar

You can see Black Market Arms Vendor here.

>give a very rare sword to black market arms vendor
(Black Market Arms Vendor) Hahaha, wow you got guts snooping around in HQ, on the right, there is a secret path that leads to the port. You  should be able to find someone to sneak you onboard from there.

You give the very rare sword to Black Market Arms Vendor.

>east
*ERKKK* *CREEEEEK *DOGEE* the secret pathway opened!

Secret path

>east
You can't go that way.

>south
port
You can see a ship here.

* * *

>west
West Wing
A nice, boring looking hall..

You can see a large amount of money here.

>take large amount of money
 Is this a trap? Meh.

Taken.

>west
You can't go that way.

>east
Government HQ Lobby
 You're back where you started. 

You can see a desk and a chair here.

* * *

>north
HQ Lounge
You find yourself in the lounge of the HQ however there is only one soldier in here who seems awfully dumb.  

You can see Dumb Navy Officer here.

>give large amount of money to dumb navy officer
Dumb Navy Officer doesn't seem interested.